    Ashtanga Namaskara - Eight-Limbed Pose
    Chakravakasana - Cat-Cow Pose
    Eka Pada Rajakapotasana II - One-Legged King Pigeon Pose II
    Anantasana - Side-Reclining Leg Lift
    Kapotasana - Pigeon Pose
    Hanumanasana - Monkey Pose (Splits)
    Parighasana - Gate Pose
    Marichyasana I - Marichi's Pose I
    Tittibhasana - Firefly Pose
    Janu Sirsasana - Head-to-Knee Forward Bend
    Yoganidrasana - Yogic Sleep Pose
    Kurmasana - Tortoise Pose
    Ananda Balasana - Happy Baby Pose
    Krounchasana - Heron Pose
    Phalakasana - Plank Pose
    Garbha Pindasana - Embryo in Womb Pose
    Adho Mukha Svanasana - Downward-Facing Dog Pose
    Eka Pada Koundinyanasana I - One-Legged Sage Koundinya's Pose I
    Vajrasana - Thunderbolt Pose
    Padmasana - Lotus Pose
    Virabhadrasana I - Warrior I Pose
    Salamba Bhujangasana - Sphinx Pose
    Parivrtta Trikonasana - Revolved Triangle Pose
    Supta Virasana - Reclining Hero Pose
    Lolasana - Pendant Pose
    Supta Baddha Konasana - Reclining Bound Angle Pose
    Upavistha Konasana - Seated Wide-Angle Pose
    Tolasana - Scale Pose
    Simhasana - Lion Pose
    Ardha Pincha Mayurasana - Dolphin Pose
    Ardha Bhekasana - Half Frog Pose
    Camatkarasana - Wild Thing Pose
    Malasana - Garland Pose
    Uttanasana - Standing Forward Bend
    Urdhva Mukha Svanasana - Upward-Facing Dog Pose
    Tadasana - Mountain Pose
    Durvasasana - Durvasasana Pose
    Eka Pada Koundinyanasana II - One-Legged Sage Koundinya's Pose II
    Chaturanga Dandasana - Four-Limbed Staff Pose
    Virasana - Hero Pose
    Natarajasana - Lord of the Dance Pose
    Ustrasana - Camel Pose
    Baddha Konasana - Bound Angle Pose
    Bhekasana - Frog Pose
    Matsyasana - Fish Pose
    Utthita Hasta Padangusthasana - Extended Hand-to-Big-Toe Pose
    Parsva Bakasana - Side Crow Pose
    Marichyasana III - Marichi's Pose III
    Dandasana - Staff Pose
    Tulasana - Scale Pose (another name)
    Utkatasana - Chair Pose
    Purvottanasana - Upward Plank Pose
    Sukhasana - Easy Pose
    Bhujangasana - Cobra Pose
    Viparita Karani - Legs-Up-the-Wall Pose
    Vasisthasana - Side Plank Pose
    Makarasana - Crocodile Pose
    Bakasana - Crow Pose
    Ardha Chandrasana - Half Moon Pose
    Astavakrasana - Eight-Angle Pose
    Gomukhasana - Cow Face Pose
    Bharadvajasana I - Bharadvaja's Twist I
    Utthita Parsvakonasana - Extended Side Angle Pose
    Urdhva Prasarita Eka Padasana - Standing Split Pose
    Mayurasana - Peacock Pose
    Adho Mukha Vrksasana - Handstand
    Anjaneyasana - Crescent Lunge Pose
    Salamba Sarvangasana - Supported Shoulder Stand Pose
    Agnistambhasana - Fire Log Pose
    Prasarita Padottanasana - Wide-Legged Forward Bend
    Utthita Ashwa Sanchalanasana - Extended High Lunge Pose
    Dwi Pada Viparita Dandasana - Upward-Facing Two-Foot Staff Pose
    Ardha Matsyendrasana - Half Lord of the Fishes Pose
    Paschimottanasana - Seated Forward Bend
    Ganda Bherundasana - Formidable Face Pose
    Padangusthasana - Big Toe Pose
    Salabhasana - Locust Pose
    Virabhadrasana III - Warrior III Pose
    Virabhadrasana II - Warrior II Pose
    Garudasana - Eagle Pose
    Setu Bandha Sarvangasana - Bridge Pose
    Ardha Uttanasana - Half Forward Bend
    Halasana - Plow Pose
    Pincha Mayurasana - Feathered Peacock Pose (Forearm Stand)
    Supta Padangusthasana - Reclining Hand-to-Big-Toe Pose
    Urdhva Hastasana - Upward Salute
    Uttana Shishosana - Extended Puppy Pose
    Parivrtta Janu Sirsasana - Revolved Head-to-Knee Pose
    Vrischikasana - Scorpion Pose
    Urdhva Dhanurasana - Upward Bow Pose (Wheel Pose)
    Utthita Trikonasana - Extended Triangle Pose
    Paripurna Navasana - Full Boat Pose
    Bitilasana - Cow Pose
    Parivrtta Parsvakonasana - Revolved Side Angle Pose
    Bhujapidasana - Shoulder-Pressing Pose
    Balasana - Child's Pose
    Bhairavasana - Destroyer of the Universe Pose
    Salamba Sirsasana - Supported Headstand Pose
    Vriksasana - Tree Pose
    Eka Pada Rajakapotasana - One-Legged King Pigeon Pose
    Dhanurasana - Bow Pose
    Marjaryasana - Cat Pose
    Savasana - Corpse Pose
    Parsvottanasana - Pyramid Pose
    Supta Matsyendrasana - Reclining Lord of the Fishes Pose
    Makara Adho Mukha Svanasana - Dolphin Plank Pose
    Pasasana - Noose Pose

